####################################L#####################################################
#****************************************************************************************#
#                                                                                        #
#                                                                                        #
#                                                                                   W    #
#                                                                                        #
#                                                                                        #
#                                                                                        #
#         W                                                                              #
#                                                                                        #
#\\\\\\\\\\\\\\\\\\\\\\\\\\\\\\\\\\\\\\\\\\\\\\\\\\\\\\\\\\\\\\\\\\\\\\\\\\\\\\\\\\\\\\\\#
#                              \                                                         #
#                                                                                        #
#                                                                                        #
#                                                         \                              #
#                                                                                        #
#                                  \                                                     #
#                    \                                                                   #
#                                                            \                           #
#                                             \                                          #
#      \                                                                                 #
#                                                                                        #
#                                                                                        #
#                                 \                                                      #
#                                                               \                        #
#                                                                                        #
#                                                                                        #
#                                                                                        #
#                                                                                        #
#                                                                                        #
#                                   R                                                    #
#                                                                                        #
##########################################################################################