#####################################################################################################
R   * *       #   #     #       #       #     #   #     #             #       #     #     #   #     #
### # # # ### ### # ### # ##### # ### # # ### # # # ### # ### ### ### # ##### # ### ### # # ### ### #
# # # # # #       #   #     #   # #   # # # # # #   #   # # # #   #     #     #   #     # #     # # #
# # # # # ########### ##### # ### ### # # # # # ##### ### # # # ##### ##### ####### ##### ####### # #
#   #   # #       #   #     #   #   # #   #   # #     # #   # # #   # #     #       #     #       # #
### ##### # # ### # ### ####### ### ########### # ##### ##### # ### # ### ### ##### # ####### ##### #
#     #   # #   # # #   #     #     #   # #     #       #   # #     # #   #   #   # #     #   #   # #
# ##### ### # ### # # ### ### ####### # # # ### ##### ### ### ####### # ### # # # ####### # ### # # #
#   #       #   # # # #   # #       # # #     # #         #   #     # #     # # #       #       # # #
### # ######### # # # # ### # ##### ### ##### ### ### ##### ### # ### ######### ####### ##### ##### #
#   #   #       #   #   # #   #   #     #   # #   #     #   #   #     #   #   #     #   #   # #     #
# ##### ### ######### ### ##### # ####### # # # ######### ### ######### # # # ##### # ### # ### #####
# #   # #   #   #   #   #     # #   #     # * # *       # #   #         # # #   # # # #   #     #   #
# # # # # ##### ### ### ##### # ### # ##### # # ####### # ##### ##### ### ##### # # # # ######### # #
#   # # #         #   #   #   #   # #     # # #   #     #   #   #   # #   #     #   # #   #       # #
##### # # ##### # ### ### ### ### # ##### # # ### # # ### # # ##### ### ### ##### ### ### # ####### #
#   #   # #     #   #   #   #   # #   # # # # # #   #     # #     #     #   #   # # #     # # #     #
# ####### ####### ##### ### ### ##### # # # # # # ######### ##### ######### ### # # ####### # # #####
#         #       *     #         # # # # #   # # #   # #       #   *   #     #     #     # #   #   #
# ######### ####### ########### # # # # # ##### ### # # # ######### # ### # # ### ####### # ##### # #
# #   #     #     # #   #   # # # #     # #   #     # # # #       # #     # # # # #         #   # # #
# # ### ##### ### # # ### # # # # ### # # # # ####### # # # ##### # ####### # # # # ##### ### # # # #
# #       #   #   # #     #   # #     #     # #       # #   #     #       # #   # #   # #   # # # # #
####### # # ### ### ####### # # ######### ### ### ##### ##### ######### ### ### # # # # ### # # ### #
#   #   # #   # #   #   #   #   #   #   # # #     #   #                     #     # #   #   # #     #
# # # ### ### # # ### # ########### # # # # # ##### # ####### ######### ####### ####### # ##### #####
# # #   # #   #   #   #   #         # # #   #   # # #   #   # #   #     #       #       # #         #
# ##### ### ####### ### # # ### ##### # ####### # # ### ### # # ### ##### # ##### ####### # ####### #
#                   #   #   #   #     #         #   #         #     #     #       #         *       O
#####################################################################################################