#########################################################################################################################################################################################################
    #   #       #     #       #   #                 #   #         #   #   #         #             #   #   #             #   #   #               #   #   #   #   #   #     #     #     #       #         #
### # # # ##### # ### # # ### # # # ############### ### # ####### ### # # ######### ### ####### # # # # # # ####### ##### # # # ############# # # # ### # # # # ### # ### ##### # ### ##### # # ####### #
#   # #   #     #   # # #   #   # #   #   #     #       #       #   # # #         #     # #   # #   #   #   # #       #   #   #     # #   #   #   # #   # # # #   # # #   #   #   # # #     # #       # #
# ### ##### ### ### # # ### ##### ### # # # ### # ############### # # ########### ####### # # # ########### # # ##### # # ######### # # # # ####### # ### # # ### # # ##### # ##### # # ##### ##### # ###
#     # #   #   #   # # #   #   #   # # #   # #   #   #     #     # #     #     #       #   #   #   #   #   #       # # # #     #   # # #   #     #   #   #   #   # #   #   # #   #     #   # #   # #   #
####### # ### ####### # # ### # ### # # ##### ##### # # ### # ##### # ### # ### ####### # ####### # # ### ######### ### # # ### # ### # ##### ### # ### ########### ### # ### # # ### ### # # # # ##### #
#     #   #   # #   # # #     #   #   #   #   #   # #   #     #     #   #   #   #     # # #       #   #     #     #     # # #   #       #   # #   #   #         #   # # #   #   #   #     # #   #   #   #
##### # ### # # # # # # ######### ####### # # # # ####### # ### ############# # # ### # # ######### ### ##### ### # ####### # ##### ##### # # ####### ######### # ### # ########### ####### # ##### # ###
#   # # #   #   # #   # #       # #     #   #   #     #   #   #   #       #   # #   #   # #   #   #   # #   # #   #     #   #   #     #   # #   #   #   # #   # # # # #   #         #       # #   #     #
# # # # # ####### # ### ####### # # ### ####### ##### # ##### ### # ##### ##### ### # ### # # # # ### # # # # ######### # ####### ### # ### ### # # ### # # ### # # # ### # ################### # ##### #
# #   # #   #     #   #       #   #   #       # # #   # #   # #   # #   #   #   #   #   # # #   #   # #   # #   #     #     #   # #   # #     # # #     # #       #   #   #     #               #     # #
# ##### ### # ####### ####### ####### ####### # # # ##### # # # ### # ### # # ######### # # ####### # ##### ### ##### ####### # # # ### ##### # # ####### ##### ##### # ####### # ################### # #
# #     # #     #   #   #       #   #       # # #   #     #   #     #     #   #   #       # # #     #   # #     #     #       #   # #   #     # #       #     # #   # #     #   #   #         #   # # # #
# # ##### ##### # # ### # ### # ### ##### # # # # ### ##### ######### ########### # ### # # # # ####### # # ##### ####### ######### # ### ##### ####### ### # # # # # # ##### ##### # ####### ### # # # #
# #       #   #   # #   # #   #     #   # # # # #     #   # #     # #       #   # #   # # # #   #         #   #   #       #   #   # # #   #   #   #   #     #     # # #     #   # # # #   # # #   #     #
# ######### # ##### # ### ########### # ### # ##### ### ### # ### # ### ##### # # ##### # # ##### ########### # ### ####### ### # # # # ##### # # # ############### # ##### ### # # # # # # # # #########
#     #     #       #   #   #   #   # #     #     #   #   # # # # #   #     # #     #   # #     #   #     #   # #   #     # #   #   # #     # # #       #         #   #   #   #     #   #   # # # #     #
##### # # ##### ####### ### # # # # # ####### # ##### ### # # # # # # ##### # ####### ### # ### ### ##### ##### # ####### # # ### ### ##### # ##### # # ####### # ##### ##### ### ####### ### # # # ### #
#   #   #     #   #   #     # # # # #     #   #     #   #   #   # # #       #     #   # # #   #     #       #   #         # # # #     #     # #   # # #         # #   # #     # #   #     #   # #   #   #
# # ############# # ######### # # # ##### ######### # # # ####### # ##### ##### # # ### # ### ####### ##### # ############# # # ####### ##### # # # ########### # ### # # ### # ### ####### ### # #######
# #           #   #           # # #     #   #   # #   # #   #   #   #   #     # # # #     # #     #   #     # #     #     #     # #   #     #   # #   #     #   # #   # # # # # #         # #   #       #
# ########### # ######### ##### # ##### ### # # # ##### ##### ####### # ##### # # # # ##### ##### # ######### ##### # ### ### ### # ##### # ##### # # # ### ##### # ### # # # # # ####### # # ####### # #
#     #   #   # #   #   #     # #     #     # #   #   #   #   #   # # # #     # # # #   #   #   # #         #       # # #   #   # #       #       # #   #   #     # #     # # # #     #   # #         # #
##### # # # ### ### # # ##### # ####### ##### ##### # ### # ### # # # ### ##### # # ### # ### # # ######### ### ##### # ####### # ####################### ### ##### # ##### # # ##### # ### ########### #
#   # # # # #     # # #   #   #         #   #   #   #   # # #   #   # #   #     # #   #   #   #   #   #   # #       #   #   # # #       # #           #   # #       #   #   # # #     #   # # #       # #
# ### ### # ##### # # ### # ######### ### # ### # ##### # # # ####### # ### ####### # # ### ####### # # # # ####### # ### # # # ##### # # # ######### # ### ### ####### # ### # # ##### # # # # # ##### #
#     #   # #   #   # #   # #         #   # # # # #   #   # # #       # #         # # # #   #   #   #   #   #     # #     # # #       #   #     #     #   # #   #       #   # #     # # #       # #     #
####### ### # ##### # # ### # ########### # # # # ### ##### # ##### ### ######### # # ### ### # # ### ####### ### # ####### # ############### # # ####### # # ### ##### # # # ### # # # ##### ### # #####
#     #   #         # #     #       #   # # # # #     #   # #           #   # #   # #   # #   # #   # #       # # # #       #           #   # # #   #   #   # # # #     # # #   # # #   #   # #   #   # #
# ### ### ######### # ############# # # # # # # # ####### # ####### ### # # # # ##### # # # ### ##### # ####### # # # ######### ####### # # ### ### # # ##### # # ####### # ### # # ### # # ### ##### # #
#   #   #         # # #   #   #     # #   # #   # #       #         # # # # #         #   #   #       #         #   #       #   #   # #   # #     #   #       # #   #   # #   # # #   #   #   #       # #
### ### ####### # # # # # # # # ##### # ### # ### # ######### ####### # # # ### ############# ################# ########### ### # # # ##### # ### ############# ### # # # # ### # ### ####### ### ##### #
# # # #         #   # # #   # #       #   # # #   # #     #         #   # #     #   # #     #     #           #   #     #   #   # # # #   # #   #             #     # #   # #   #   #       #   #       #
# # # ############### # ##### ####### # # ### # ### # ### ######### ### # # ####### # # # # ##### # ####### # ### # ### # # # ### # # # # # ### # ##### ##### ####### ##### # ##### ####### ### ##### # #
#   #       #       #       # #       # #   #   #   #   # #         #   # # #   #   #   # #     # # #   #   #   # # # # # #   #   # # # #   #   #   # #   #   #   # # #     # #   #   #     # #   #   # #
########### # ############### # ####### ### ##### ##### # # ############# # # # # ####### ##### # # # # # ####### # # # # ####### # # # # ### ##### # ### ##### # # # ####### # # ### ####### ### #######
#       #     #         #     #   #     #   # #   #   # # #   #     #     # # #   #       #   # # #   # # #     # #   # # #   #   # # # # #   #   # #   #   #   # # #   #     # # #   #     #       #   #
### ### ### ### ####### # ######### ######### # ### # # # ### # # ### ####### ##### ####### # ### ##### # # ### # ##### # # ### ### # ### # ##### # # ##### # ### # ### ### ### # # ### ### ####### # # #
#     # #   #   #       # #       #   #       #   # # # #   #   #         #   #   #   #   # # #       # #   #   # #   # # #     #   # #   # #   # #   #     #   #   # # #   # # # # #   #       #     # #
# # # # # ### ######### # # ##### ### # # ##### ### # # # ################# ### # ### # # # # # ##### ### ####### # # # ##### ### ### # ##### # # ##### ####### # ### # # ### # # # # ### ####### ##### #
# # # # #   # #           # #   # # # # # #     #   # # # #   #         #   #   #   # # #   # # #     #   #     # # # #   #   #   #   #   #   # # #   #         #     # # #     # # #   # #       #   # #
# ### # ### # # ########### # # # # # ### # ##### ### # # # ### ### ### # ####### # # # ##### # # ### # ### ### # # # ### ##### ### ##### # ### # # # # ############### # ####### ##### # # ######### # #
# #   #   #   #     #     # # # #   # #   # #     # # # #     #   # #   # # #   # #     #   #   #   # # #   # # # # #   #   #     # # #   #   #     #     # #   #       # #     #     # # #   #       # #
### ##### ######### # # ### # ### ### # ### # ##### # # ##### ### # ##### # # # ##### ### ######### ### # ### # # ### ##### # # # # # # ### ########### # # # # ### ##### # ### ### ### # ### # ### #####
#   #   #     #     # #     #       #   # # # #   #   # # #   # # #     # #   #     # #   #         #   # #   #     #     #   # #     #   # #           # #   # #         # #     #   # #   # # #   #   #
# # # # ##### ##### # ################### # # # # # ### # # ### # ##### # # # ### ### # ### ######### ### # ####### ##### ##### ### ### ### # ########### ##### # # ####### ##### ### # ### # # ##### # #
# #   #     #   #     #   #     #         # # # #   #   #     #   #   # # # #   #     # #   #   #   # # # #       #     #     #   #       # #         #   #   #   # #     #     #       # # # #       # #
# ######### ### ##### # # ##### ##### ##### ### # ### ############# # # # ##### ### ### # # # # # # # # # ##### # ### ##### ##### ####### # # ####### # ### # # ##### ### ##### ##### ### # # # ####### #
# #     #   #         # #     # #     #   #     # # # #   #     #   # # #   #   #   # # # #   # # #   #   #     # #   #       #         #   #   #     #   # # #       # #   # # #       #   # #   #   # #
# # ### # ################### # # ### # # # ##### # # ### # ### # ##### ### # ### ### # ####### # ######### # ### # ### ##### # # ##### ####### # ####### # # ##### ### ### # # ######### ### ### # ### #
# # # # #   #   #       #     # # #   # #   #     #     # # # #   #     #   #   #   #           #     #   # #   #   #   #   #   #     # #       # #     #   # #   #       # #     #     #   #   #   #   #
# # # # ### # # # ##### ### ### # # ### ########### ### # # # # ##### ### ##### ### ### ############# # # # ### ##### ### # # ####### # ##### ### # ######### # # # ##### # ##### # ### ### ### ##### ###
#   #   #   # # # # #       #     # #   #       #   #       #   #     #   #   #   #   #   #   #       # # #   # #     #   # #     #   # #   # #     #         # # # #   # #       # # # #   #   #   #   #
######### ### # # # # ####### # ### # ######### # ### # ######### # # # # # # ### ### ### # # # ####### # ### # # ##### ### ####### ### # # ### ##### ######### # ### ### ##### ### # # ### # # # # ### #
#         #   # #   #       # # #   #     #   # # #   #     #   # # # # # # #     # #   #   #   #       #   # # # #   # #   # #     #   # #   # #   #     #     # #   #   #   #   #   #     # # # #   # #
# ######### ### # ######### # # # # ##### ### # ### # ##### # # ### # # # # ####### ### ######### ########### # # ### # ##### # ##### ### # # # ### ##### # ##### # # # ### # ### ############# ### # # #
#   #   #     # #     #   #   # # # #       # # #   #     # # #     #   # #   #   #           #       #       # #   #           #     #   # # #     #   # #     # # #   #   #   #       # #   #   # # # #
### # # # ##### # ### # # ####### # # ##### # # # ####### # # ########### ### # ####### ##### ### ### # ########### ### ######### ########### ######### # # ##### ####### # ### ####### # # # ### # # # #
#   # # # #   #   #     #   # #   # # # #   #   #   #     #   #   #     #   #   #         #   #   #   # #         # #   #   #   #       # #   #           # #       #     #   # #   #   # # #   # # # # #
# ### # # ### ####### ##### # # ##### # # ### ##### ##### ### ### # ### # # # ### ######### ### ####### # ##### ### # ##### # ######### # # ##### ##### ##### ### # ######### # # # # ### # ### # ### # #
#   # # #   #   #   #   #   # # #   # #   #   #   #     #   #     #   # # # #   #   #       # # #   #       #   #   # #     #           #   #     #   #   #   # # #           # # # # #     #   # #   # #
### # # # # ### # # ##### ### # # # # # ### ##### ##### ### ########### # # ### ### # ##### # # # # # ##### ##### ### # ############# # # ### ##### # ##### ### # # ######### ### # # # # ### ### # ### #
#   # # # # # #   #     #   # #   #   #     #     #     # # #   #     # # #     #   # #   #   #   # #     #       #   #   # #   #   # #   # #     # #   #   #   # #     #   #     #   # #   #   # #     #
# ### # ### # # ####### # # # ##### ######### ### # # ### # # # # ### # ######### ### # # ####### # ######### ####### ### # # ### # ####### # ### # ### # ### ### # ### # # ########### # # ##### # # ###
#   # #     #   #     #   # #   #   #     # # # # # # # #   # # # #   # #         #   # #       # #       #     #     #   # #     #   #     # # # # #   # #   #   # #   # #             # #         #   #
### # ########### ### ######### # ####### # # # # # # # ##### ### # ### # ######### ### # ### ### ####### # # # # ##### # # # ### ### # ##### # # # # ### # ### ### ##### ##### # # ############# ##### #
#   # #     #   #   #         # #       #   # #   # # #   # # #   # #   # #       #     #   #   # #   #   # # # #     # # # # #   # # #   # # # # # # #   # #   #   #   # #   # # # #             #   # #
# ### ##### # # ### ######### # ####### # ### ### # # ### # # # ### # ### # ##### ######### ### # # # # ### # # ##### # ### ### ### # ### # # # # # # # ### # # # ### # # # # ### # # ############# # ###
#     #     # #   #         # #     #     #     #   # #   #     # # # # # #   # #       #   # # # # #   #   # #   #   #     #   #   #   # #   # # # #   # # # # #   # #   # #     # #       #     # #   #
### ### ##### ### ######### # ### # # # ### ######### # ######### # # # # ### # ####### ### # # # # ##### ### ### ### # ##### ### ##### # ##### # # ##### # # # # ### ##### ############### # ### ##### #
# #   # #     # #       #   #     # # # #   # #   #   #       # #   # #   #   #   #   # #   # #   #       #   #     # # #   # #     # # #       #   #   # # # # #   # #     #           #     #         #
# ### # # ##### ####### # ### ##### ### # ### # # # ### ##### # # ### # ### ### # # # # # ### ##################### # # # # # # # # # # ####### ##### # # # # # ### # # ####### ####### # # ### # #######
# # #   #   #   #   #   #   # #   #           # # # # #     #   #       #     # #   # #     #       #               #   # # #   # #   #   #   # #   # #   # # # # #   # #         #   #   # #   #   #   #
# # ##### ### ### # ### ### ### # # ### ####### # # # # ### ### ### ##### ### # ##### ############# # ############# ####### ########### # # # # ### # # ### ### # ##### # ######### # ##### # ##### # # #
# #     #       # #     #   #   #   # # #       #   #   # # # #   # #   #   #   #   # #     #   # #   #               #         #       #   # #       #   #   # #       #   #     # # #     #     #   # #
# ##### ####### # ######### # ####### # # ####### ### ### # # # # ### # ### ##### # # # ### # # # ####### ######### # ##### ### # ################# ####### # # # ######### # ### # # # ######### ##### #
#               #     #   # # #     #   #   #   # # # #     #   #   # # #   #     # #   #   # #   #     # #         #     # #   #   #   #     #   # #     # #   # #         #   #   # # # #     #   # # #
################# # ### # ### ##### ####### # ### # # # ########### # # # ### ### # ##### # # ##### # # ### ######### # ### # ##### ### # ### # # # # ### ######### ######### # ### ### # # ### ### # # #
#                 #     #           #       #     #   #           #   #   #   #   #       #   #     # #     #         #     #               #   # #   #             #         #   #     #   #       #   O
#########################################################################################################################################################################################################