######
#   L#
# ####
#  R #
######