###########
#....R....#
#.*******.#
#.#######.#
#.       .#
#..*\\\*..#
#.#*\\\*#.#
#########L#

Water 0
Flooding 10
Waterproof 5