######
#*  R#
# ####
# ####
# ####
# ####
# ####
# \L##
# ####
######