######
#*  R#
# ####
# ####
# ####
# ####
# ####
# \L##
######
######